{
  "maps": [
    {
      "title": "dungeon",
      "tiles": [
        "####################",
        "##...........#######",
        "##.#########.#######",
        "#...#........L...###",
        "#...#.##D##D####...#",
        "#.T.#.#...#..K.#.#.#",
        "#####.#...#....#...#",
        "#####D##.####.##.#.#",
        "###....#....#.#....#",
        "###....####D#.#....#",
        "###.P..#T.....#..B.#",
        "####################"
      ]
    }
  ]
}