{
    "dungeon": {
        "tiles": [
            "####################",
            "##...........#######",
            "##.#########.#######",
            "#...#........L...###",
            "#...#.##D##L####...#",
            "#.T.#.#...#..K.#.#.#",
            "#####.#...#....#...#",
            "#####D##.####.##.#.#",
            "###....#....#.#....#",
            "###....####D#.#....#",
            "###.@..#T.....#..B.#",
            "####################"
        ]
    }
}